alreadyConnected=节点已连接
cancel=取消
close=关闭
collapse-expand=点击折叠 / 展开\nShift-点击以移动周边图形 \nAlt-点击以保护组别尺寸
containsValidationErrors=包含验证错误
done=完成
doubleClickOrientation=双击以改变方向
error=出错
errorSavingFile=保存文件出错
ok=确定
updatingDocument=文件更新中。请稍候...
updatingSelection=选择更新中。请稍候...
about=关于 
actualSize=实际尺寸
add=添加
addLayer=添加图层
addProperty=添加属性
addToExistingDrawing=添加至当前绘图
addWaypoint=添加航点
advanced=高级
align=对齐
alignment=对齐
allChangesLost=所有修改均将会丢失！
angle=角度
apply=应用
arc=圆弧
arrange=调整图形
arrow=箭头
arrows=箭头
automatic=自动
autosave=自动保存
autosize=自动调整
back=后退
background=背景
backgroundColor=背景色
backgroundImage=背景图片
basic=基本
block=区块
blockquote=区块引言
bold=粗体
border=边框
borderWidth=边框宽度
borderColor=边框颜色
bottom=下
bottomAlign=向下对齐
bottomLeft=左下
bottomRight=右下
bulletedList=项目符号列表
cannotOpenFile=无法打开文件
center=水平居中
change=更改
changeOrientation=改变方向
circle=圆形
classic=经典
clearDefaultStyle=清除默认风格
clearWaypoints=清除航点
clipart=剪贴画
collapse=折叠
collapseExpand=折叠 / 展开
collapsible=可折叠
comic=手绘
connect=连接
connection=连接
connectionPoints=连接点
connectionArrows=连接箭头
constrainProportions=限制比例
copy=复制
copyConnect=连接时复制
copySize=复制大小
create=创建
curved=曲线
custom=自定义
cut=剪切
dashed=虚线
decreaseIndent=减少缩进
default=默认值
delete=删除
deleteColumn=删除列
deleteRow=删除行
diagram=绘图
diamond=方块
diamondThin=方块（细）
direction=方向
distribute=等距分布
divider=分隔线
documentProperties=文件属性
dotted=点线
dpi=DPI
drawing=绘图 {1}
drawingEmpty=绘图空白
drawingTooLarge=绘图过大
duplicate=创建副本
duplicateIt=复制 {1}
east=向右
edit=编辑
editData=编辑数据
editDiagram=编辑绘图
editImage=编辑图片
editLink=编辑链接
editStyle=编辑样式
editTooltip=编辑提示
enterGroup=进入组进行编辑
enterValue=输入值
enterName=输入名称
enterPropertyName=输入属性名
entityRelation=实体关系
exitGroup=退出编辑组
expand=展开
export=导出
extras=其它
file=文件
fileNotFound=未找到文件
filename=文件名
fill=填充
fillColor=填充色
fitPage=整页显示
fitPageWidth=适应页面宽度
fitTwoPages=双页
fitWindow=适应窗口大小
flip=翻转
flipH=水平翻转
flipV=垂直翻转
font=字体
fontFamily=字体
fontColor=字体颜色
fontSize=字体大小
format=格式
formatPanel=格式面板
general=通用
formatPdf=PDF
formatPng=PNG
formatGif=GIF
formatJpg=JPEG
formatSvg=SVG
formatXml=XML
formatted=格式化
formattedText=格式化文本
gap=间隙
glass=玻璃
global=全局
gradient=渐变
gradientColor=颜色
grid=网格
gridSize=网格大小
group=组合
guides=参考线
heading=标题
height=高
help=帮助
hide=隐藏
hideIt=隐藏 {1}
hidden=已隐藏
home=首页
horizontal=水平
horizontalFlow=水平流
horizontalTree=水平树
html=HTML
id=ID
image=图片
images=图片
import=导入
increaseIndent=增加缩进
insert=插入
insertColumnBefore=左边插入列
insertColumnAfter=右边插入列
insertHorizontalRule=插入水平标尺
insertImage=插入图片
insertLink=插入链接
insertRowBefore=上方插入行
insertRowAfter=下方插入行
invalidInput=无效输入
invalidName=无效名称
invalidOrMissingFile=无效或丢失的文件
isometric=等尺寸
italic=斜体
layers=图层
landscape=横向
laneColor=泳道颜色
layout=布局
left=左
leftAlign=左对齐
leftToRight=右对齐
line=线条
link=连接
lineJumps=跨线
lineend=线末端
lineheight=行高
linestart=线始端
linewidth=线宽
loading=加载中
lockUnlock=锁定 / 解锁
manual=手册
middle=垂直居中
misc=杂项
more=更多
moreResults=更多结果
move=移动
moveSelectionTo=将所选移至 {1}
navigation=导航
new=新建
noColor=无颜色
noFiles=无文件
noMoreResults=无其他结果
none=无
noResultsFor=未找到 '{1}' 的相关结果
normal=正常
north=向上
numberedList=编号列表
opacity=不透明度
open=打开
openArrow=开放的箭头
openFile=打开文件
openLink=打开链接
openSupported=支持的格式有本软件保存的文件 (.xml), .vsdx 及 .gliffy
openInNewWindow=在新窗口打开
openInThisWindow=在当前窗口打开
options=选项
organic=力导向布局图
orthogonal=正交
outline=缩略图
oval=椭圆形
pages=页面
pageView=页面视图
pageScale=页面比例
pageSetup=页面设置
panTooltip=按住空格键并拖拽以移动画布
paperSize=页面尺寸
paste=粘贴
pasteHere=在这粘贴
pasteSize=粘贴大小
pattern=样式
perimeter=周长
placeholders=占位符
plusTooltip=单击进行连接与复制（ctrl+单击进行复制，shift+单击进行连接）。拖拽进行连接（ctrl+拖拽进行复制）。
portrait=竖向
position=位置
posterPrint=海报样式
preview=预览
print=打印
radialTree=径向树
redo=重做
removeFormat=清除格式
removeFromGroup=移出组合
removeIt=删除 {1}
removeWaypoint=删除航点
rename=重命名
renameIt=重命名 {1}
replace=替换
replaceIt={1} 已经存在了。确定要替换它吗？
replaceExistingDrawing=替换当前绘图
reset=重置
resetView=重置视图
reverse=翻转
right=右
rightAlign=右对齐
rightToLeft=由右至左
rotate=旋转
rotateTooltip=点选拖拽旋转，或点击选择90度
rotation=旋转
sketch=素描
rounded=圆角
save=保存
saveAs=另存为
saved=已保存
scrollbars=滚动条
search=搜索
searchShapes=搜索图形
selectAll=全选
selectEdges=选择边线
selectFont=选择字体
selectNone=全不选
selectVertices=选择顶点
setAsDefaultStyle=设置为默认样式
shadow=阴影
shape=形状
sharp=锐利
sidebarTooltip=单击以展开。将图形拖拽至绘图中。Shift+单击以改变所选内容。Alt+单击以插入及连接。
simple=简单
simpleArrow=简单箭头
size=大小
solid=实线
sourceSpacing=源距
south=向下
spacing=间距
straight=直线
strikethrough=删除线
strokeColor=线条颜色
style=样式
subscript=下标
superscript=上标
table=表格
targetSpacing=目标间距
text=文本
textAlignment=文本对齐
textOpacity=字体不透明度
toBack=移至最后
toFront=移至最前
tooltips=提示
top=上
topAlign=向上对齐
topLeft=左上
topRight=右上
transparent=透明
turn=旋转90°
uml=UML
underline=下划线
undo=撤销
ungroup=取消组合
url=URL
untitledLayer=未命名图层
vertical=垂直
verticalFlow=垂直流
verticalTree=垂直树
view=查看
waypoints=航点
west=向左
width=宽
wordWrap=自动换行
writingDirection=书写方向
zoom=缩放
zoomIn=放大
zoomOut=缩小